1111111111111
15D15C5121261
1261C5C120321
13215B5121111
10111011012A1
1223222322221
1011222121111
1321121121261
1251222120351
16d1222121111
1111121131221
1E22222120291
1111111111111
