1111111111111
1923332222221
1111111111121
1622021D52121
1232121d62121
1101121110121
1522120333121
1232121111121
1101122222221
1222110111011
1625152212321
168512E213C31
1111111111111
