1111111111111
1222229222221
12fff222fff21
12f2f222f2f21
12fff222fff21
12222A2A22221
1111112111111
116F5F2F5F611
1162522252611
112F2F2F2F211
112F2F2F2F211
111111P111111
1111111111111