1111111111111
12B2122212A21
16251272152C1
1222122212321
110111F111011
1232023223221
1222111111111
1323222222221
1011011101101
1212321232121
1213251D26121
19153512321E1
1111111111111