1111111111111
1212221d1d229
1212121213121
1212121212121
1013131313121
1222022202121
1212131312131
1212121212121
1212121212121
1212161213261
92121D1232111
1232F212F2F71
1111111111111